0000000100000000000000000
0000000110000000000000000
0000000111000000000000000
0000000111100110000000000
0000000011100010000000000
0000000011010110000000000
0000000010011101100000000
0000000010010011100000000
0000000100100010000000000
000S000100000010010000T00
0000001101110001001000000
0000001000000011001000000
0000011001000100110000000
0000000001101010000000000
0000001100000111000000000
0000001010111010000000000
0000100001100010010000000
0000110000001100001000000
0001000010111100000000000
0001000001101100010000000
0000110001100100000000000
0000001011000001000000000
0100000000000000000000000
1000000000000000000000000
0000000000000000000000000
